@ *player*
# *wall*
h :chair
[ :table-left
] :table-right
= :counter
( :fridge-left
) :fridge-right
{ :vending-machine-left
} :vending-machine-right
% :closed-door
< :bird
  ()

             ############################################################
             #        #=========#=================####         #{}      #
             #        #                                ####()()#{}    {}#
             #        #=========# #===============#### #{}{}####      {}#
             #                                                          #
  ######     #                                                          #     ######
  #____#     #  h[]h  h[]h  h[]h  h[]h  h[]h  h[]h  h[]h  h[]h  h[]h    #     #____#
  #____#######  h[]h  h[]h  h[]h  h[]h  h[]h  h[]h  h[]h  h[]h  h[]h    #######____#
  %          #  h[]h  h[]h  h[]h  h[]h  h[]h  h[]h  h[]h  h[]h  h[]h    #          %
  %             h[]h  h[]h  h[]h  h[]h  h[]h  h[]h  h[]h  h[]h  h[]h               %
  #          #  h[]h  h[]h  h[]h  h[]h  h[]h  h[]h  h[]h  h[]h  h[]h    #          #
  ############@ h[]h  h[]h  h[]h  h[]h  h[]h  h[]h  h[]h  h[]h  h[]h    ############
             ############################################################
                                      <
