| *wall*
` *wall*
' *wall*
- *wall*
. *wall*
_ :stair
% :closed-door
~ :info-point
  ()

                                       ##%%%##
                                       #     #
                                       #     #
             ###########################--   ############################
             #                   #                 #                    #
             #                   #    _________    #                    #
 ##########%##                   #___|_________|___#                    #
 #           #                   #___|_________|___#                    #
 #___.---.___#                   #___|_________|___#                    #     ######
 #___|   |___#######%#####%#######---'         `---########%#####%#######     #____#
 #####   |___#                   #                 #                    #######____#
 %                                                                      #          %
 %                                                                                 %
 #                                                                                 #
 #           #                         ~~~~~~~                          ############
 #           ############################################################
 #           #
 #           #
 #           %
 #           #
 %           #
 #           #
 ####%%#######
